5 10
##########
#     + *#
#     O  #
#x    O  #
##########