7 40
|############+#######|#################|
|##    #####++###    ###   ######OOO---|
OO   x  #######      O       OOO++++OOOO
OOO####+##OO###   *  O      ##O+++x++OOO
OO++##O###OO##xx    OOO    ###OO+++OOOOO
O#+###+##+++##########|################O
|#####################|################O